11111111111111111
1P000000000000001
10000000000000001
10000000000000001
10000000000000001
10000000000000001
10000000000000001
10000000000000001
10000000000000001
10000000000000001
10000000000000001
10000000000000001
10000000000000001
10000000000000001
10000000000000001
10000000000000001
10000000000000001
10E00C00C00000001
11111111111111111