11111111111111111111
100011111110000000P1
10E0000C00000C000001
100011111110000C0001
10001000001000000001
1000100000100000C001
11111111111111111111