11111111111111
1C000E00C00001
10C01111110001
10001P00010001
10001000010001
100000000CC001
11111111111111
