111111111111111111111111111111111111111111111111
100000000000000000000000000000000000000000000001
100000000000000000000000000000000000000000000001
100000000000000000000000000000000000000000000001
100011111111111111111111111111111111111110111111
100010000000000000000010000000000000000000000001
100010000C00000000000010000000000000000000000001
100010000000000000000011011111111111111111111111
100010000000000000000000000000000000CC0010000001
10C010000000011111111011001111111000CC0010000001
10001000000001000C00000100000C001000CC0010000001
100010000000011111111111001111111000CC0010000001
1000100000000X0000P00000000001000000CC0010000C01
100000000000011111111111001111111111111110000001
100010000000000000100000000000000000000000000001
100010000000011111111111001000000000000000000001
100010000000000000000000001000000000000000000001
100010000000000000000000000000000000000000000001
100011111001111100111110011100000000000000000001
100010000000010000001000000100000000000000000001
10001010C0000100C000100C000100000000000000000001
111111111111111111111111111111111111111111111111