11111111
10000001
10000001
100000k1
11111111