110111111111111111111111
101000000000000000000001
111111111111111111111101