111111111111111111111111
100000000000X00000000001
100000000000000000000001
1000P0C01000000000000001
100000000000000000000001
100000000000000000000001
100000000000000000000001
1000000000C0000000000001
100000000000000000000001
100000000000000000000001
100000000000000000000001
100000000000000000000001
100000000000000000000001
100000000000000000000001
100000000000000000000001
111111111111111111111111