11111111111111111111
100011111110000000P1
10M000M010000M000001
100011111110000M0001
10001000001000000001
1000100000100000M001
11111111111111111111