111111111111111111111111
1P0110000000000000000001
100011000000C00000000001
1100000000000C0000000001
111000000C00000000000011
111111000000000000000111
1000C11000C0000000001111
110000100000000000111111
100C00000000000011111111
1000000000100000000000E1
111111111111111111111111