11111111111111111111111111111111111111
1P000000000000000000000000000000000001
11101111111111111111111111111111111101
10001000000000000000000000000000000001
10111011111111111111111111111111111101
10100010000000000000000000000000000001
10101110111111111111111111111111111101
10100010000000000000000000000000000001
10111110111111111111111111111111111101
10000000100000000000000000000000000001
11111110111111111111111111111111111101
10000010000000000000000000000000000001
10111111111111111111111111111111111101
10100000000000000000000000000000000001
10101111111111111111111111111111111101
10100000000000000000000000000000000001
10111111111111111111111111111111111101
10000000000000000000000000000000000001
11111111111111111111111111111111111101
10000000000000000000000000000000000001
10111111111111111111111111111111111101
10100000000000000000000000000000000001
10101111111111111111111111111111111101
10100000000000000000000000000000000001
10111111111111111111111111111111111101
10000000000000000000000000000000000001
11111111111111111111111111111111111101
10000000000000000000000000000000000001
10111111111111111111111111111111111101
1C0000000000000000000000000000000000E1
11111111111111111111111111111111111111