11111111111111
10000X00C00001
10001111110001
10001P00010001
10001000010001
1000000000C001
11111111111111