1111111111111111111111111111111111111111111111111111111111111111111111111111111111111111111111111111
1P00000000000000000000000000000000000000000000000000000000000000000000000000000000000000000000000001
1110111111111111111111111111111111111111111111111111111111111111111111111111111111111111111111111101
1000100000000000000000000000000000000000000000000000000000000000000000000000000000000000000000000001
1011101111111111111111111111111111111111111111111111111111111111111111111111111111111111111111111101
1010001000000000000000000000000000000000000000000000000000000000000000000000000000000000000000000001
1010111011111111111111111111111111111111111111111111111111111111111111111111111111111111111111111101
1010001000000000000000000000000000000000000000000000000000000000000000000000000000000000000000000001
1011111011111111111111111111111111111111111111111111111111111111111111111111111111111111111111111101
1000000010000000000000000000000000000000000000000000000000000000000000000000000000000000000000000001
1111111011111111111111111111111111111111111111111111111111111111111111111111111111111111111111111101
1000001000000000000000000000000000000000000000000000000000000000000000000000000000000000000000000001
1011111111111111111111111111111111111111111111111111111111111111111111111111111111111111111111111101
10100000000000000000000000000000000000000000000000000000000000000000C0000000000000000000000000000001
1010111111111111111111111111111111111111111111111111111111111111111111111111111111111111111111111101
1010000000000000000000000000000000000000000000000000000000000000000000000000000000000000000000000001
1011111111111111111111111111111111111111111111111111111111111111111111111111111111111111111111111101
1000000000000000000000000000000000000000000000000000000000000000000000000000000000000000000000000001
1111111111111111111111111111111111111111111111111111111111111111111111111111111111111111111111111101
1000000000000000000000000000000000000000000000000X00000000000000000000000000000000000000000000000001
1111111111111111111111111111111111111111111111111111111111111111111111111111111111111111111111111111